+-+-+-+-+-+-+-+
|   | |     | |
+-+ + + +-+ + +
|       |   | |
+ + +-+ + + + +
| |   |   |   |
+-+ + + + +-+-+
| | | | |   | |
+ + +-+ + +-+ +
| | |   | | | |
+ + + + +-+ + +
|   | |   |   |
+-+ + + + + + +
|   | | | | | |
+-+ + + + +-+ +
|   | | | | | |
+-+ + +-+ + + +
|       |     |
+-+-+-+-+-+-+-+
